Disse folketingsmedlemmer vil i byråd



 Her er de 28 folketingspolitikere , der stiller op til efterårets kommunalvalg og hvilken kommune, de stiller op i.
* Socialdemokratiet:
 Jacob Bjerregaard - Fredericia
Torben Hansen - Randers
* Socialistisk Folkeparti:
 Pernille Vigsø Bagge - Vesthimmerland
* Enhedslisten:
Per Clausen - Aalborg
* Venstre:
Ulla Tørnæs - Holstebro
Lars Christian Lilleholt - Odense
Jane Heitmann - Fåborg
Flemming Damgård-Larsen - Lejre
Finn Thranum - Odder
Karsten Nonbo - Næstved
Jan E. Jørgensen - Frederiksberg
Henrik Høegh - Lolland
Tina Nedergaard - Mariagerfjord
Martin Geertsen - Region Hovedstaden
* Konservative:
Benedikte Kiær - Helsingør
Mai Henriksen - Frederiksberg
* Dansk Folkeparti:
Jens Henrik Thulesen Dahl - Assens
Pia Adelsteen - Frederikssund
Liselott Blixt - Greve
 René Christensen - Guldborgsund
Mikkel Dencker - Hvidovre
Hans Kristian Skibby - Hedensted
Morten Marinus - Jammerbugt
Mette Hjermind Dencker - Hvidovre
Jørn Dohrmann - Kolding
Alex Ahrendtsen - Odense
Dennis Flydtkjær - Herning
* Liberal Alliance:
Villum Christensen - Slagelse
